8 8 
G	G	G	G	G	G	G	G
G	R	R	R	R	R	R	G
G	G	G	G	G	G	R	G
G	R	R	R	R	G	R	G
G	R	G	G	R	G	R	G
G	R	G	G	G	G	R	G
G	R	R	R	R	R	R	G
G	G	G	G	G	G	G	G
